ID,Pokemon,Legendary,Stat Total,ATK Sum,DEF Sum,Height,Weight,Type 1,Type 2
1,bulbasaur,False,318,159,159,7,69,poison,grass
2,ivysaur,False,405,202,203,10,130,poison,grass
3,venusaur,False,525,262,263,20,1000,poison,grass
4,charmander,False,309,177,132,6,85,fire,N/A
5,charmeleon,False,405,224,181,11,190,fire,N/A
6,charizard,False,534,293,241,17,905,flying,fire
7,squirtle,False,314,141,173,5,90,water,N/A
8,wartortle,False,405,186,219,10,225,water,N/A
9,blastoise,False,530,246,284,16,855,water,N/A
10,caterpie,False,195,95,100,3,29,bug,N/A
11,metapod,False,205,75,130,7,99,bug,N/A
12,butterfree,False,395,205,190,11,320,flying,bug
13,weedle,False,195,105,90,3,32,poison,bug
14,kakuna,False,205,85,120,6,100,poison,bug
15,beedrill,False,395,210,185,10,295,poison,bug
16,pidgey,False,251,136,115,3,18,flying,normal
17,pidgeotto,False,349,181,168,11,300,flying,normal
18,pidgeot,False,479,251,228,15,395,flying,normal
19,rattata,False,253,153,100,3,35,normal,N/A
20,raticate,False,413,228,185,7,185,normal,N/A
21,spearow,False,262,161,101,3,20,flying,normal
22,fearow,False,442,251,191,12,380,flying,normal
23,ekans,False,288,155,133,20,69,poison,N/A
24,arbok,False,448,240,208,35,650,poison,N/A
25,pikachu,False,320,195,125,4,60,electric,N/A
26,raichu,False,485,290,195,8,300,electric,N/A
27,sandshrew,False,300,135,165,6,120,ground,N/A
28,sandslash,False,450,210,240,10,295,ground,N/A
29,nidoran-f,False,275,128,147,4,70,poison,N/A
30,nidorina,False,365,173,192,8,200,poison,N/A
31,nidoqueen,False,505,243,262,13,600,ground,poison
32,nidoran-m,False,273,147,126,5,90,poison,N/A
33,nidorino,False,365,192,173,9,195,poison,N/A
34,nidoking,False,505,272,233,14,620,ground,poison
35,clefairy,False,323,140,183,6,75,fairy,N/A
36,clefable,False,483,225,258,13,400,fairy,N/A
37,vulpix,False,299,156,143,6,99,fire,N/A
38,ninetales,False,505,257,248,11,199,fire,N/A
39,jigglypuff,False,270,110,160,5,55,fairy,normal
40,wigglytuff,False,435,200,235,10,120,fairy,normal
41,zubat,False,245,130,115,8,75,flying,poison
42,golbat,False,455,235,220,16,550,flying,poison
43,oddish,False,320,155,165,5,54,poison,grass
44,gloom,False,395,190,205,8,86,poison,grass
45,vileplume,False,490,240,250,12,186,poison,grass
46,paras,False,285,140,145,3,54,grass,bug
47,parasect,False,405,185,220,10,295,grass,bug
48,venonat,False,305,140,165,10,300,poison,bug
49,venomoth,False,450,245,205,15,125,poison,bug
50,diglett,False,265,185,80,2,8,ground,N/A
51,dugtrio,False,425,270,155,7,333,ground,N/A
52,meowth,False,290,175,115,4,42,normal,N/A
53,persian,False,440,250,190,10,320,normal,N/A
54,psyduck,False,320,172,148,8,196,water,N/A
55,golduck,False,500,262,238,17,766,water,N/A
56,mankey,False,305,185,120,5,280,fighting,N/A
57,primeape,False,455,260,195,10,320,fighting,N/A
58,growlithe,False,350,200,150,7,190,fire,N/A
59,arcanine,False,555,305,250,19,1550,fire,N/A
60,poliwag,False,300,180,120,6,124,water,N/A
61,poliwhirl,False,385,205,180,10,200,water,N/A
62,poliwrath,False,510,235,275,13,540,fighting,water
63,abra,False,310,215,95,9,195,psychic,N/A
64,kadabra,False,400,260,140,13,565,psychic,N/A
65,alakazam,False,500,305,195,15,480,psychic,N/A
66,machop,False,305,150,155,8,195,fighting,N/A
67,machoke,False,405,195,210,15,705,fighting,N/A
68,machamp,False,505,250,255,16,1300,fighting,N/A
69,bellsprout,False,300,185,115,7,40,poison,grass
70,weepinbell,False,390,230,160,10,64,poison,grass
71,victreebel,False,490,275,215,17,155,poison,grass
72,tentacool,False,335,160,175,9,455,poison,water
73,tentacruel,False,515,250,265,16,550,poison,water
74,geodude,False,300,130,170,4,200,ground,rock
75,graveler,False,390,175,215,10,1050,ground,rock
76,golem,False,495,220,275,14,3000,ground,rock
77,ponyta,False,410,240,170,10,300,fire,N/A
78,rapidash,False,500,285,215,17,950,fire,N/A
79,slowpoke,False,315,120,195,12,360,psychic,water
80,slowbro,False,490,205,285,16,785,psychic,water
81,magnemite,False,325,175,150,3,60,steel,electric
82,magneton,False,465,250,215,10,600,steel,electric
83,farfetchd,False,377,208,169,8,150,flying,normal
84,doduo,False,310,195,115,14,392,flying,normal
85,dodrio,False,470,280,190,18,852,flying,normal
86,seel,False,325,135,190,11,900,water,N/A
87,dewgong,False,475,210,265,17,1200,ice,water
88,grimer,False,325,145,180,9,300,poison,N/A
89,muk,False,500,220,280,12,300,poison,N/A
90,shellder,False,305,150,155,3,40,water,N/A
91,cloyster,False,525,250,275,15,1325,ice,water
92,gastly,False,310,215,95,13,1,poison,ghost
93,haunter,False,405,260,145,16,1,poison,ghost
94,gengar,False,500,305,195,15,405,poison,ghost
95,onix,False,385,145,240,88,2100,ground,rock
96,drowzee,False,328,133,195,10,324,psychic,N/A
97,hypno,False,483,213,270,16,756,psychic,N/A
98,krabby,False,325,180,145,4,65,water,N/A
99,kingler,False,475,255,220,13,600,water,N/A
100,voltorb,False,330,185,145,5,104,electric,N/A
101,electrode,False,490,280,210,12,666,electric,N/A
102,exeggcute,False,325,140,185,4,25,psychic,grass
103,exeggutor,False,530,275,255,20,1200,psychic,grass
104,cubone,False,320,125,195,4,65,ground,N/A
105,marowak,False,425,175,250,10,450,ground,N/A
106,hitmonlee,False,455,242,213,15,498,fighting,N/A
107,hitmonchan,False,455,216,239,14,502,fighting,N/A
108,lickitung,False,385,145,240,12,655,normal,N/A
109,koffing,False,340,160,180,6,10,poison,N/A
110,weezing,False,490,235,255,12,95,poison,N/A
111,rhyhorn,False,345,140,205,10,1150,rock,ground
112,rhydon,False,485,215,270,19,1200,rock,ground
113,chansey,False,450,90,360,11,346,normal,N/A
114,tangela,False,435,215,220,10,350,grass,N/A
115,kangaskhan,False,490,225,265,22,800,normal,N/A
116,horsea,False,295,170,125,4,80,water,N/A
117,seadra,False,440,245,195,12,250,water,N/A
118,goldeen,False,320,165,155,6,150,water,N/A
119,seaking,False,450,225,225,13,390,water,N/A
120,staryu,False,340,200,140,8,345,water,N/A
121,starmie,False,520,290,230,11,800,psychic,water
122,mr-mime,False,460,235,225,13,545,fairy,psychic
123,scyther,False,500,270,230,15,560,flying,bug
124,jynx,False,455,260,195,14,406,psychic,ice
125,electabuzz,False,490,283,207,11,300,electric,N/A
126,magmar,False,495,288,207,13,445,fire,N/A
127,pinsir,False,500,265,235,15,550,bug,N/A
128,tauros,False,490,250,240,14,884,normal,N/A
129,magikarp,False,200,105,95,9,100,water,N/A
130,gyarados,False,540,266,274,65,2350,flying,water
131,lapras,False,535,230,305,25,2200,ice,water
132,ditto,False,288,144,144,3,40,normal,N/A
133,eevee,False,325,155,170,3,65,normal,N/A
134,vaporeon,False,525,240,285,10,290,water,N/A
135,jolteon,False,525,305,220,8,245,electric,N/A
136,flareon,False,525,290,235,9,250,fire,N/A
137,porygon,False,395,185,210,8,365,normal,N/A
138,omanyte,False,355,165,190,4,75,water,rock
139,omastar,False,495,230,265,10,350,water,rock
140,kabuto,False,355,190,165,5,115,water,rock
141,kabutops,False,495,260,235,13,405,water,rock
142,aerodactyl,False,515,295,220,18,590,flying,rock
143,snorlax,False,540,205,335,21,4600,normal,N/A
144,articuno,True,580,265,315,17,554,flying,ice
145,zapdos,True,580,315,265,16,526,flying,electric
146,moltres,True,580,315,265,20,600,flying,fire
147,dratini,False,300,164,136,18,33,dragon,N/A
148,dragonair,False,420,224,196,40,165,dragon,N/A
149,dragonite,False,600,314,286,22,2100,flying,dragon
150,mewtwo,True,680,394,286,20,1220,psychic,N/A
151,mew,True,600,300,300,4,40,psychic,N/A
152,chikorita,False,318,143,175,9,64,grass,N/A
153,bayleef,False,405,185,220,12,158,grass,N/A
154,meganium,False,525,245,280,18,1005,grass,N/A
155,cyndaquil,False,309,177,132,5,79,fire,N/A
156,quilava,False,405,224,181,9,190,fire,N/A
157,typhlosion,False,534,293,241,17,795,fire,N/A
158,totodile,False,314,152,162,6,95,water,N/A
159,croconaw,False,405,197,208,11,250,water,N/A
160,feraligatr,False,530,262,268,23,888,water,N/A
161,sentret,False,215,101,114,8,60,normal,N/A
162,furret,False,415,211,204,18,325,normal,N/A
163,hoothoot,False,262,116,146,7,212,flying,normal
164,noctowl,False,452,206,246,16,408,flying,normal
165,ledyba,False,265,115,150,10,108,flying,bug
166,ledian,False,390,175,215,14,356,flying,bug
167,spinarak,False,250,130,120,5,85,poison,bug
168,ariados,False,400,190,210,11,335,poison,bug
169,crobat,False,535,290,245,18,750,flying,poison
170,chinchou,False,330,161,169,5,120,electric,water
171,lanturn,False,460,201,259,12,225,electric,water
172,pichu,False,205,135,70,3,20,electric,N/A
173,cleffa,False,218,85,133,3,30,fairy,N/A
174,igglybuff,False,210,85,125,3,10,fairy,normal
175,togepi,False,245,80,165,3,15,fairy,N/A
176,togetic,False,405,160,245,6,32,flying,fairy
177,natu,False,320,190,130,2,20,flying,psychic
178,xatu,False,470,265,205,15,150,flying,psychic
179,mareep,False,280,140,140,6,78,electric,N/A
180,flaaffy,False,365,180,185,8,133,electric,N/A
181,ampharos,False,510,245,265,14,615,electric,N/A
182,bellossom,False,490,220,270,4,58,grass,N/A
183,marill,False,250,80,170,4,85,fairy,water
184,azumarill,False,420,160,260,8,285,fairy,water
185,sudowoodo,False,410,160,250,12,380,rock,N/A
186,politoed,False,500,235,265,11,339,water,N/A
187,hoppip,False,250,120,130,4,5,flying,grass
188,skiploom,False,340,170,170,6,10,flying,grass
189,jumpluff,False,460,220,240,8,30,flying,grass
190,aipom,False,360,195,165,8,115,normal,N/A
191,sunkern,False,180,90,90,3,18,grass,N/A
192,sunflora,False,425,210,215,8,85,grass,N/A
193,yanma,False,390,235,155,12,380,flying,bug
194,wooper,False,210,85,125,4,85,ground,water
195,quagsire,False,430,185,245,14,750,ground,water
196,espeon,False,525,305,220,9,265,psychic,N/A
197,umbreon,False,525,190,335,10,270,dark,N/A
198,murkrow,False,405,261,144,5,21,flying,dark
199,slowking,False,490,205,285,20,795,psychic,water
200,misdreavus,False,435,230,205,7,10,ghost,N/A
201,unown,False,336,192,144,5,50,psychic,N/A
202,wobbuffet,False,405,99,306,13,285,psychic,N/A
203,girafarig,False,455,255,200,15,415,psychic,normal
204,pineco,False,290,115,175,6,72,bug,N/A
205,forretress,False,465,190,275,12,1258,steel,bug
206,dunsparce,False,415,180,235,15,140,normal,N/A
207,gligar,False,430,195,235,11,648,flying,ground
208,steelix,False,510,170,340,92,4000,ground,steel
209,snubbull,False,300,150,150,6,78,fairy,N/A
210,granbull,False,450,225,225,14,487,fairy,N/A
211,qwilfish,False,440,235,205,5,39,poison,water
212,scizor,False,500,250,250,18,1180,steel,bug
213,shuckle,False,505,25,480,6,205,rock,bug
214,heracross,False,500,250,250,15,540,fighting,bug
215,sneasel,False,430,245,185,9,280,ice,dark
216,teddiursa,False,330,170,160,6,88,normal,N/A
217,ursaring,False,500,260,240,18,1258,normal,N/A
218,slugma,False,250,130,120,7,350,fire,N/A
219,magcargo,False,430,170,260,8,550,rock,fire
220,swinub,False,250,130,120,4,65,ground,ice
221,piloswine,False,450,210,240,11,558,ground,ice
222,corsola,False,410,155,255,6,50,rock,water
223,remoraid,False,300,195,105,6,120,water,N/A
224,octillery,False,480,255,225,9,285,water,N/A
225,delibird,False,330,195,135,9,160,flying,ice
226,mantine,False,485,190,295,21,2200,flying,water
227,skarmory,False,465,190,275,17,505,flying,steel
228,houndour,False,330,205,125,6,108,fire,dark
229,houndoom,False,500,295,205,14,350,fire,dark
230,kingdra,False,540,275,265,18,1520,dragon,water
231,phanpy,False,330,140,190,5,335,ground,N/A
232,donphan,False,500,230,270,11,1200,ground,N/A
233,porygon2,False,515,245,270,6,325,normal,N/A
234,stantler,False,465,265,200,14,712,normal,N/A
235,smeargle,False,250,115,135,12,580,normal,N/A
236,tyrogue,False,210,105,105,7,210,fighting,N/A
237,hitmontop,False,455,200,255,14,480,fighting,N/A
238,smoochum,False,305,180,125,4,60,psychic,ice
239,elekid,False,360,223,137,6,235,electric,N/A
240,magby,False,365,228,137,7,214,fire,N/A
241,miltank,False,490,220,270,12,755,normal,N/A
242,blissey,False,540,140,400,15,468,normal,N/A
243,raikou,True,580,315,265,19,1780,electric,N/A
244,entei,True,580,305,275,21,1980,fire,N/A
245,suicune,True,580,250,330,20,1870,water,N/A
246,larvitar,False,300,150,150,6,720,ground,rock
247,pupitar,False,410,200,210,12,1520,ground,rock
248,tyranitar,False,600,290,310,20,2020,dark,rock
249,lugia,True,680,290,390,52,2160,flying,psychic
250,ho-oh,True,680,330,350,38,1990,flying,fire
251,celebi,True,600,300,300,6,50,grass,psychic
252,treecko,False,310,180,130,5,50,grass,N/A
253,grovyle,False,405,245,160,9,216,grass,N/A
254,sceptile,False,530,310,220,17,522,grass,N/A
255,torchic,False,310,175,135,4,25,fire,N/A
256,combusken,False,405,225,180,9,195,fighting,fire
257,blaziken,False,530,310,220,19,520,fighting,fire
258,mudkip,False,310,160,150,4,76,water,N/A
259,marshtomp,False,405,195,210,7,280,ground,water
260,swampert,False,535,255,280,15,819,ground,water
261,poochyena,False,220,120,100,5,136,dark,N/A
262,mightyena,False,420,220,200,10,370,dark,N/A
263,zigzagoon,False,240,120,120,4,175,normal,N/A
264,linoone,False,420,220,200,5,325,normal,N/A
265,wurmple,False,195,85,110,3,36,bug,N/A
266,silcoon,False,205,75,130,6,100,bug,N/A
267,beautifly,False,395,235,160,10,284,flying,bug
268,cascoon,False,205,75,130,7,115,bug,N/A
269,dustox,False,385,165,220,12,316,poison,bug
270,lotad,False,220,100,120,5,26,grass,water
271,lombre,False,340,160,180,12,325,grass,water
272,ludicolo,False,480,230,250,15,550,grass,water
273,seedot,False,220,100,120,5,40,grass,N/A
274,nuzleaf,False,340,190,150,10,280,dark,grass
275,shiftry,False,480,270,210,13,596,dark,grass
276,taillow,False,270,170,100,3,23,flying,normal
277,swellow,False,455,285,170,7,198,flying,normal
278,wingull,False,270,170,100,6,95,flying,water
279,pelipper,False,440,210,230,12,280,flying,water
280,ralts,False,198,110,88,4,66,fairy,psychic
281,kirlia,False,278,150,128,8,202,fairy,psychic
282,gardevoir,False,518,270,248,16,484,fairy,psychic
283,surskit,False,269,145,124,5,17,water,bug
284,masquerain,False,454,240,214,8,36,flying,bug
285,shroomish,False,295,115,180,4,45,grass,N/A
286,breloom,False,460,260,200,12,392,fighting,grass
287,slakoth,False,280,125,155,8,240,normal,N/A
288,vigoroth,False,440,225,215,14,465,normal,N/A
289,slaking,False,670,355,315,20,1305,normal,N/A
290,nincada,False,266,115,151,5,55,ground,bug
291,ninjask,False,456,300,156,8,120,flying,bug
292,shedinja,False,236,160,76,8,12,ghost,bug
293,whismur,False,240,130,110,6,163,normal,N/A
294,loudred,False,360,190,170,10,405,normal,N/A
295,exploud,False,490,250,240,15,840,normal,N/A
296,makuhita,False,237,105,132,10,864,fighting,N/A
297,hariyama,False,474,210,264,23,2538,fighting,N/A
298,azurill,False,190,60,130,2,20,fairy,normal
299,nosepass,False,375,120,255,10,970,rock,N/A
300,skitty,False,260,130,130,6,110,normal,N/A
301,delcatty,False,400,210,190,11,326,normal,N/A
302,sableye,False,380,190,190,5,110,ghost,dark
303,mawile,False,380,190,190,6,115,fairy,steel
304,aron,False,330,140,190,4,600,rock,steel
305,lairon,False,430,180,250,9,1200,rock,steel
306,aggron,False,530,220,310,21,3600,rock,steel
307,meditite,False,280,140,140,6,112,psychic,fighting
308,medicham,False,410,200,210,13,315,psychic,fighting
309,electrike,False,295,175,120,6,152,electric,N/A
310,manectric,False,475,285,190,15,402,electric,N/A
311,plusle,False,405,230,175,4,42,electric,N/A
312,minun,False,405,210,195,4,42,electric,N/A
313,volbeat,False,430,205,225,7,177,bug,N/A
314,illumise,False,430,205,225,6,177,bug,N/A
315,roselia,False,400,225,175,3,20,poison,grass
316,gulpin,False,302,126,176,4,103,poison,N/A
317,swalot,False,467,201,266,17,800,poison,N/A
318,carvanha,False,305,220,85,8,208,dark,water
319,sharpedo,False,460,310,150,18,888,dark,water
320,wailmer,False,400,200,200,20,1300,water,N/A
321,wailord,False,500,240,260,145,3980,water,N/A
322,numel,False,305,160,145,7,240,ground,fire
323,camerupt,False,460,245,215,19,2200,ground,fire
324,torkoal,False,470,190,280,5,804,fire,N/A
325,spoink,False,330,155,175,7,306,psychic,N/A
326,grumpig,False,470,215,255,9,715,psychic,N/A
327,spinda,False,360,180,180,11,50,normal,N/A
328,trapinch,False,290,155,135,7,150,ground,N/A
329,vibrava,False,340,190,150,11,153,dragon,ground
330,flygon,False,520,280,240,20,820,dragon,ground
331,cacnea,False,335,205,130,4,513,grass,N/A
332,cacturne,False,475,285,190,13,774,dark,grass
333,swablu,False,310,130,180,4,12,flying,normal
334,altaria,False,490,220,270,11,206,flying,dragon
335,zangoose,False,458,265,193,13,403,normal,N/A
336,seviper,False,458,265,193,27,525,poison,N/A
337,lunatone,False,460,220,240,10,1680,psychic,rock
338,solrock,False,460,220,240,12,1540,psychic,rock
339,barboach,False,288,154,134,4,19,ground,water
340,whiscash,False,468,214,254,9,236,ground,water
341,corphish,False,308,165,143,6,115,water,N/A
342,crawdaunt,False,468,265,203,11,328,dark,water
343,baltoy,False,300,135,165,5,215,psychic,ground
344,claydol,False,500,215,285,15,1080,psychic,ground
345,lileep,False,355,125,230,10,238,grass,rock
346,cradily,False,495,205,290,15,604,grass,rock
347,anorith,False,355,210,145,7,125,bug,rock
348,armaldo,False,495,240,255,15,682,bug,rock
349,feebas,False,200,105,95,6,74,water,N/A
350,milotic,False,540,241,299,62,1620,water,N/A
351,castform,False,420,210,210,3,8,normal,N/A
352,kecleon,False,440,190,250,10,220,normal,N/A
353,shuppet,False,295,183,112,6,23,ghost,N/A
354,banette,False,455,263,192,11,125,ghost,N/A
355,duskull,False,295,95,200,8,150,ghost,N/A
356,dusclops,False,455,155,300,16,306,ghost,N/A
357,tropius,False,460,191,269,20,1000,flying,grass
358,chimecho,False,455,210,245,6,10,psychic,N/A
359,absol,False,465,280,185,12,470,dark,N/A
360,wynaut,False,260,69,191,6,140,psychic,N/A
361,snorunt,False,300,150,150,7,168,ice,N/A
362,glalie,False,480,240,240,15,2565,ice,N/A
363,spheal,False,290,120,170,8,395,water,ice
364,sealeo,False,410,180,230,11,876,water,ice
365,walrein,False,530,240,290,14,1506,water,ice
366,clamperl,False,345,170,175,4,525,water,N/A
367,huntail,False,485,250,235,17,270,water,N/A
368,gorebyss,False,485,250,235,18,226,water,N/A
369,relicanth,False,485,190,295,10,234,rock,water
370,luvdisc,False,330,167,163,6,87,water,N/A
371,bagon,False,300,165,135,6,421,dragon,N/A
372,shelgon,False,420,205,215,11,1105,dragon,N/A
373,salamence,False,600,345,255,15,1026,flying,dragon
374,beldum,False,300,120,180,6,952,psychic,steel
375,metang,False,420,180,240,12,2025,psychic,steel
376,metagross,False,600,300,300,16,5500,psychic,steel
377,regirock,True,580,200,380,17,2300,rock,N/A
378,regice,True,580,200,380,18,1750,ice,N/A
379,registeel,True,580,200,380,19,2050,steel,N/A
380,latias,True,600,300,300,14,400,psychic,dragon
381,latios,True,600,330,270,20,600,psychic,dragon
382,kyogre,True,670,340,330,45,3520,water,N/A
383,groudon,True,670,340,330,35,9500,ground,N/A
384,rayquaza,True,680,395,285,70,2065,flying,dragon
385,jirachi,True,600,300,300,3,11,psychic,steel
386,deoxys-normal,True,600,450,150,17,608,psychic,N/A
387,turtwig,False,318,144,174,4,102,grass,N/A
388,grotle,False,405,180,225,11,970,grass,N/A
389,torterra,False,525,240,285,22,3100,ground,grass
390,chimchar,False,309,177,132,5,62,fire,N/A
391,monferno,False,405,237,168,9,220,fighting,fire
392,infernape,False,534,316,218,12,550,fighting,fire
393,piplup,False,314,152,162,4,52,water,N/A
394,prinplup,False,405,197,208,8,230,water,N/A
395,empoleon,False,530,257,273,17,845,steel,water
396,starly,False,245,145,100,3,20,flying,normal
397,staravia,False,340,195,145,6,155,flying,normal
398,staraptor,False,485,270,215,12,249,flying,normal
399,bidoof,False,250,111,139,5,200,normal,N/A
400,bibarel,False,410,211,199,10,315,water,normal
401,kricketot,False,194,75,119,3,22,bug,N/A
402,kricketune,False,384,205,179,10,255,bug,N/A
403,shinx,False,263,150,113,5,95,electric,N/A
404,luxio,False,363,205,158,9,305,electric,N/A
405,luxray,False,523,285,238,14,420,electric,N/A
406,budew,False,280,135,145,2,12,poison,grass
407,roserade,False,515,285,230,9,145,poison,grass
408,cranidos,False,350,213,137,9,315,rock,N/A
409,rampardos,False,495,288,207,16,1025,rock,N/A
410,shieldon,False,350,114,236,5,570,steel,rock
411,bastiodon,False,495,129,366,13,1495,steel,rock
412,burmy,False,224,94,130,2,34,bug,N/A
413,wormadam-plant,False,424,174,250,5,65,grass,bug
414,mothim,False,424,254,170,9,233,flying,bug
415,combee,False,244,130,114,3,55,flying,bug
416,vespiquen,False,474,200,274,12,385,flying,bug
417,pachirisu,False,405,185,220,4,39,electric,N/A
418,buizel,False,330,210,120,7,295,water,N/A
419,floatzel,False,495,305,190,11,335,water,N/A
420,cherubi,False,275,132,143,4,33,grass,N/A
421,cherrim,False,450,232,218,5,93,grass,N/A
422,shellos,False,325,139,186,3,63,water,N/A
423,gastrodon,False,475,214,261,9,299,ground,water
424,ambipom,False,482,275,207,12,203,normal,N/A
425,drifloon,False,348,180,168,4,12,flying,ghost
426,drifblim,False,498,250,248,12,150,flying,ghost
427,buneary,False,350,195,155,4,55,normal,N/A
428,lopunny,False,480,235,245,12,333,normal,N/A
429,mismagius,False,495,270,225,9,44,ghost,N/A
430,honchkrow,False,505,301,204,9,273,flying,dark
431,glameow,False,310,182,128,5,39,normal,N/A
432,purugly,False,452,258,194,10,438,normal,N/A
433,chingling,False,285,140,145,2,6,psychic,N/A
434,stunky,False,329,178,151,4,192,dark,poison
435,skuntank,False,479,248,231,10,380,dark,poison
436,bronzor,False,300,71,229,5,605,psychic,steel
437,bronzong,False,500,201,299,13,1870,psychic,steel
438,bonsly,False,290,100,190,5,150,rock,N/A
439,mime-jr,False,310,155,155,6,130,fairy,psychic
440,happiny,False,220,50,170,6,244,normal,N/A
441,chatot,False,411,248,163,5,19,flying,normal
442,spiritomb,False,485,219,266,10,1080,dark,ghost
443,gible,False,300,152,148,7,205,ground,dragon
444,gabite,False,410,222,188,14,560,ground,dragon
445,garchomp,False,600,312,288,19,950,ground,dragon
446,munchlax,False,390,130,260,6,1050,normal,N/A
447,riolu,False,285,165,120,7,202,fighting,N/A
448,lucario,False,525,315,210,12,540,steel,fighting
449,hippopotas,False,330,142,188,8,495,ground,N/A
450,hippowdon,False,525,227,298,20,3000,ground,N/A
451,skorupi,False,330,145,185,8,120,bug,poison
452,drapion,False,500,245,255,13,615,dark,poison
453,croagunk,False,300,172,128,7,230,fighting,poison
454,toxicroak,False,490,277,213,13,444,fighting,poison
455,carnivine,False,454,236,218,14,270,grass,N/A
456,finneon,False,330,164,166,4,70,water,N/A
457,lumineon,False,460,229,231,12,240,water,N/A
458,mantyke,False,345,130,215,10,650,flying,water
459,snover,False,334,164,170,10,505,ice,grass
460,abomasnow,False,494,244,250,22,1355,ice,grass
461,weavile,False,510,290,220,11,340,ice,dark
462,magnezone,False,535,260,275,12,1800,steel,electric
463,lickilicky,False,515,215,300,17,1400,normal,N/A
464,rhyperior,False,535,235,300,24,2828,rock,ground
465,tangrowth,False,535,260,275,20,1286,grass,N/A
466,electivire,False,540,313,227,18,1386,electric,N/A
467,magmortar,False,540,303,237,16,680,fire,N/A
468,togekiss,False,545,250,295,15,380,flying,fairy
469,yanmega,False,515,287,228,19,515,flying,bug
470,leafeon,False,525,265,260,10,255,grass,N/A
471,glaceon,False,525,255,270,8,259,ice,N/A
472,gliscor,False,510,235,275,20,425,flying,ground
473,mamoswine,False,530,280,250,25,2910,ground,ice
474,porygon-z,False,535,305,230,9,340,normal,N/A
475,gallade,False,518,270,248,16,520,fighting,psychic
476,probopass,False,525,170,355,14,3400,steel,rock
477,dusknoir,False,525,210,315,22,1066,ghost,N/A
478,froslass,False,480,270,210,13,266,ghost,ice
479,rotom,False,440,236,204,3,3,ghost,electric
480,uxie,True,580,245,335,3,3,psychic,N/A
481,mesprit,True,580,290,290,3,3,psychic,N/A
482,azelf,True,580,365,215,3,3,psychic,N/A
483,dialga,True,680,360,320,54,6830,dragon,steel
484,palkia,True,680,370,310,42,3360,dragon,water
485,heatran,True,600,297,303,17,4300,steel,fire
486,regigigas,True,670,340,330,37,4200,normal,N/A
487,giratina-altered,True,680,290,390,45,7500,dragon,ghost
488,cresselia,True,600,230,370,15,856,psychic,N/A
489,phione,True,480,240,240,4,31,water,N/A
490,manaphy,True,600,300,300,3,14,water,N/A
491,darkrai,True,600,350,250,15,505,dark,N/A
492,shaymin-land,True,600,300,300,2,21,grass,N/A
493,arceus,True,720,360,360,32,3200,normal,N/A
494,victini,True,600,300,300,4,40,fire,psychic
495,snivy,False,308,153,155,6,81,grass,N/A
496,servine,False,413,203,210,8,160,grass,N/A
497,serperior,False,528,263,265,33,630,grass,N/A
498,tepig,False,308,153,155,5,99,fire,N/A
499,pignite,False,418,218,200,10,555,fighting,fire
500,emboar,False,528,288,240,16,1500,fighting,fire
501,oshawott,False,308,163,145,5,59,water,N/A
502,dewott,False,413,218,195,8,245,water,N/A
503,samurott,False,528,278,250,15,946,water,N/A
504,patrat,False,255,132,123,5,116,normal,N/A
505,watchog,False,420,222,198,11,270,normal,N/A
506,lillipup,False,275,140,135,4,41,normal,N/A
507,herdier,False,370,175,195,9,147,normal,N/A
508,stoutland,False,500,235,265,12,610,normal,N/A
509,purrloin,False,281,166,115,4,101,dark,N/A
510,liepard,False,446,282,164,11,375,dark,N/A
511,pansage,False,316,170,146,6,105,grass,N/A
512,simisage,False,498,297,201,11,305,grass,N/A
513,pansear,False,316,170,146,6,110,fire,N/A
514,simisear,False,498,297,201,10,280,fire,N/A
515,panpour,False,316,170,146,6,135,water,N/A
516,simipour,False,498,297,201,10,290,water,N/A
517,munna,False,292,116,176,6,233,psychic,N/A
518,musharna,False,487,191,296,11,605,psychic,N/A
519,pidove,False,264,134,130,3,21,flying,normal
520,tranquill,False,358,192,166,6,150,flying,normal
521,unfezant,False,488,273,215,12,290,flying,normal
522,blitzle,False,295,186,109,8,298,electric,N/A
523,zebstrika,False,497,296,201,16,795,electric,N/A
524,roggenrola,False,280,115,165,4,180,rock,N/A
525,boldore,False,390,175,215,9,1020,rock,N/A
526,gigalith,False,515,220,295,17,2600,rock,N/A
527,woobat,False,323,172,151,4,21,flying,psychic
528,swoobat,False,425,248,177,9,105,flying,psychic
529,drilbur,False,328,183,145,3,85,ground,N/A
530,excadrill,False,508,273,235,7,404,steel,ground
531,audino,False,445,170,275,11,310,normal,N/A
532,timburr,False,305,140,165,6,125,fighting,N/A
533,gurdurr,False,405,185,220,12,400,fighting,N/A
534,conkeldurr,False,505,240,265,14,870,fighting,N/A
535,tympole,False,294,164,130,5,45,water,N/A
536,palpitoad,False,384,199,185,8,170,ground,water
537,seismitoad,False,509,254,255,15,620,ground,water
538,throh,False,465,175,290,13,555,fighting,N/A
539,sawk,False,465,240,225,14,510,fighting,N/A
540,sewaddle,False,310,135,175,3,25,grass,bug
541,swadloon,False,380,155,225,5,73,grass,bug
542,leavanny,False,500,265,235,12,205,grass,bug
543,venipede,False,260,132,128,4,53,poison,bug
544,whirlipede,False,360,142,218,12,585,poison,bug
545,scolipede,False,485,267,218,25,2005,poison,bug
546,cottonee,False,280,130,150,3,6,fairy,grass
547,whimsicott,False,480,260,220,7,66,fairy,grass
548,petilil,False,280,135,145,5,66,grass,N/A
549,lilligant,False,480,260,220,11,163,grass,N/A
550,basculin-red-striped,False,460,270,190,10,180,water,N/A
551,sandile,False,292,172,120,7,152,dark,ground
552,krokorok,False,351,201,150,10,334,dark,ground
553,krookodile,False,519,274,245,15,963,dark,ground
554,darumaka,False,315,155,160,6,375,fire,N/A
555,darmanitan-standard,False,480,265,215,13,929,fire,N/A
556,maractus,False,461,252,209,10,280,grass,N/A
557,dwebble,False,325,155,170,3,145,rock,bug
558,crustle,False,485,215,270,14,2000,rock,bug
559,scraggy,False,348,158,190,6,118,fighting,dark
560,scrafty,False,488,193,295,11,300,fighting,dark
561,sigilyph,False,490,258,232,14,140,flying,psychic
562,yamask,False,303,115,188,5,15,ghost,N/A
563,cofagrigus,False,483,175,308,17,765,ghost,N/A
564,tirtouga,False,355,153,202,7,165,rock,water
565,carracosta,False,495,223,272,12,810,rock,water
566,archen,False,401,256,145,5,95,flying,rock
567,archeops,False,567,362,205,14,320,flying,rock
568,trubbish,False,329,155,174,6,310,poison,N/A
569,garbodor,False,474,230,244,19,1073,poison,N/A
570,zorua,False,330,210,120,7,125,dark,N/A
571,zoroark,False,510,330,180,16,811,dark,N/A
572,minccino,False,300,165,135,4,58,normal,N/A
573,cinccino,False,470,275,195,5,75,normal,N/A
574,gothita,False,290,130,160,4,58,psychic,N/A
575,gothorita,False,390,175,215,7,180,psychic,N/A
576,gothitelle,False,490,215,275,15,440,psychic,N/A
577,solosis,False,290,155,135,3,10,psychic,N/A
578,duosion,False,370,195,175,6,80,psychic,N/A
579,reuniclus,False,490,220,270,10,201,psychic,N/A
580,ducklett,False,305,143,162,5,55,flying,water
581,swanna,False,473,272,201,13,242,flying,water
582,vanillite,False,305,159,146,4,57,ice,N/A
583,vanillish,False,395,204,191,11,410,ice,N/A
584,vanilluxe,False,535,284,251,13,575,ice,N/A
585,deerling,False,335,175,160,6,195,grass,normal
586,sawsbuck,False,475,255,220,19,925,grass,normal
587,emolga,False,428,253,175,4,50,flying,electric
588,karrablast,False,315,175,140,5,59,bug,N/A
589,escavalier,False,495,215,280,10,330,steel,bug
590,foongus,False,294,125,169,2,10,poison,grass
591,amoonguss,False,464,200,264,6,105,poison,grass
592,frillish,False,335,145,190,12,330,ghost,water
593,jellicent,False,480,205,275,22,1350,ghost,water
594,alomomola,False,470,180,290,12,316,water,N/A
595,joltik,False,319,169,150,1,6,electric,bug
596,galvantula,False,472,282,190,8,143,electric,bug
597,ferroseed,False,305,84,221,6,188,steel,grass
598,ferrothorn,False,489,168,321,10,1100,steel,grass
599,klink,False,300,130,170,3,210,steel,N/A
600,klang,False,440,200,240,6,510,steel,N/A
601,klinklang,False,520,260,260,6,810,steel,N/A
602,tynamo,False,275,160,115,2,3,electric,N/A
603,eelektrik,False,405,200,205,12,220,electric,N/A
604,eelektross,False,515,270,245,21,805,electric,N/A
605,elgyem,False,335,170,165,5,90,psychic,N/A
606,beheeyem,False,485,240,245,10,345,psychic,N/A
607,litwick,False,275,115,160,3,31,fire,ghost
608,lampent,False,370,190,180,6,130,fire,ghost
609,chandelure,False,520,280,240,10,343,fire,ghost
610,axew,False,320,174,146,6,180,dragon,N/A
611,fraxure,False,410,224,186,10,360,dragon,N/A
612,haxorus,False,540,304,236,18,1055,dragon,N/A
613,cubchoo,False,305,170,135,5,85,ice,N/A
614,beartic,False,505,250,255,26,2600,ice,N/A
615,cryogonal,False,515,250,265,11,1480,ice,N/A
616,shelmet,False,305,105,200,4,77,bug,N/A
617,accelgor,False,495,315,180,8,253,bug,N/A
618,stunfisk,False,471,179,292,7,110,electric,ground
619,mienfoo,False,350,205,145,9,200,fighting,N/A
620,mienshao,False,510,325,185,14,355,fighting,N/A
621,druddigon,False,485,228,257,16,1390,dragon,N/A
622,golett,False,303,144,159,10,920,ghost,ground
623,golurk,False,483,234,249,28,3300,ghost,ground
624,pawniard,False,340,185,155,5,102,steel,dark
625,bisharp,False,490,255,235,16,700,steel,dark
626,bouffalant,False,490,205,285,16,946,normal,N/A
627,rufflet,False,350,180,170,5,105,flying,normal
628,braviary,False,510,260,250,15,410,flying,normal
629,vullaby,False,370,160,210,5,90,flying,dark
630,mandibuzz,False,510,200,310,12,395,flying,dark
631,heatmor,False,484,267,217,14,580,fire,N/A
632,durant,False,484,266,218,3,330,steel,bug
633,deino,False,300,148,152,8,173,dragon,dark
634,zweilous,False,420,208,212,14,500,dragon,dark
635,hydreigon,False,600,328,272,18,1600,dragon,dark
636,larvesta,False,360,195,165,11,288,fire,bug
637,volcarona,False,550,295,255,16,460,fire,bug
638,cobalion,True,580,288,292,21,2500,fighting,steel
639,terrakion,True,580,309,271,19,2600,fighting,rock
640,virizion,True,580,288,292,20,2000,fighting,grass
641,tornadus-incarnate,True,580,351,229,15,630,flying,N/A
642,thundurus-incarnate,True,580,351,229,15,610,flying,electric
643,reshiram,True,680,360,320,32,3300,fire,dragon
644,zekrom,True,680,360,320,29,3450,electric,dragon
645,landorus-incarnate,True,600,341,259,15,680,flying,ground
646,kyurem,True,660,355,305,30,3250,ice,dragon
647,keldeo-ordinary,True,580,309,271,14,485,fighting,water
648,meloetta-aria,True,600,295,305,6,65,psychic,normal
649,genesect,True,600,339,261,15,825,steel,bug
650,chespin,False,313,147,166,4,90,grass,N/A
651,quilladin,False,405,191,214,7,290,grass,N/A
652,chesnaught,False,530,245,285,16,900,fighting,grass
653,fennekin,False,307,167,140,4,94,fire,N/A
654,braixen,False,409,222,187,10,145,fire,N/A
655,delphox,False,534,287,247,15,390,psychic,fire
656,froakie,False,314,189,125,3,70,water,N/A
657,frogadier,False,405,243,162,6,109,water,N/A
658,greninja,False,530,320,210,15,400,dark,water
659,bunnelby,False,237,125,112,4,50,normal,N/A
660,diggersby,False,423,184,239,10,424,ground,normal
661,fletchling,False,278,152,126,3,17,flying,normal
662,fletchinder,False,382,213,169,7,160,flying,fire
663,talonflame,False,499,281,218,12,245,flying,fire
664,scatterbug,False,200,97,103,3,25,bug,N/A
665,spewpa,False,213,78,135,3,84,bug,N/A
666,vivillon,False,411,231,180,12,170,flying,bug
667,litleo,False,369,195,174,6,135,normal,fire
668,pyroar,False,507,283,224,15,815,normal,fire
669,flabebe,False,303,141,162,1,1,fairy,N/A
670,floette,False,371,172,199,2,9,fairy,N/A
671,florges,False,552,252,300,11,100,fairy,N/A
672,skiddo,False,350,179,171,9,310,grass,N/A
673,gogoat,False,531,265,266,17,910,grass,N/A
674,pancham,False,348,171,177,6,80,fighting,N/A
675,pangoro,False,495,251,244,21,1360,dark,fighting
676,furfrou,False,472,247,225,12,280,normal,N/A
677,espurr,False,355,179,176,3,35,psychic,N/A
678,meowstic-male,False,466,235,231,6,85,psychic,N/A
679,honedge,False,325,143,182,8,20,ghost,steel
680,doublade,False,448,190,258,8,45,ghost,steel
681,aegislash-shield,False,520,160,360,17,530,ghost,steel
682,spritzee,False,341,138,203,2,5,fairy,N/A
683,aromatisse,False,462,200,262,8,155,fairy,N/A
684,swirlix,False,341,156,185,4,35,fairy,N/A
685,slurpuff,False,480,237,243,8,50,fairy,N/A
686,inkay,False,288,136,152,4,35,psychic,dark
687,malamar,False,482,233,249,15,470,psychic,dark
688,binacle,False,306,141,165,5,310,water,rock
689,barbaracle,False,500,227,273,13,960,water,rock
690,skrelp,False,320,150,170,5,73,water,poison
691,dragalge,False,494,216,278,18,815,dragon,poison
692,clauncher,False,330,155,175,5,83,water,N/A
693,clawitzer,False,500,252,248,13,353,water,N/A
694,helioptile,False,289,169,120,5,60,normal,electric
695,heliolisk,False,481,273,208,10,210,normal,electric
696,tyrunt,False,362,182,180,8,260,dragon,rock
697,tyrantrum,False,521,261,260,25,2700,dragon,rock
698,amaura,False,362,172,190,13,252,ice,rock
699,aurorus,False,521,234,287,27,2250,ice,rock
700,sylveon,False,525,235,290,10,235,fairy,N/A
701,hawlucha,False,500,284,216,8,215,flying,fighting
702,dedenne,False,431,240,191,2,22,fairy,electric
703,carbink,False,500,150,350,3,57,fairy,rock
704,goomy,False,300,145,155,3,28,dragon,N/A
705,sliggoo,False,452,218,234,8,175,dragon,N/A
706,goodra,False,600,290,310,20,1505,dragon,N/A
707,klefki,False,470,235,235,2,30,fairy,steel
708,phantump,False,309,158,151,4,70,grass,ghost
709,trevenant,False,474,231,243,15,710,grass,ghost
710,pumpkaboo-average,False,335,161,174,4,50,grass,ghost
711,gourgeist-average,False,494,232,262,9,125,grass,ghost
712,bergmite,False,304,129,175,10,995,ice,N/A
713,avalugg,False,514,189,325,20,5050,ice,N/A
714,noibat,False,245,130,115,5,80,dragon,flying
715,noivern,False,535,290,245,15,850,dragon,flying
716,xerneas,True,680,361,319,30,2150,fairy,N/A
717,yveltal,True,680,361,319,58,2030,flying,dark
718,zygarde,True,600,276,324,50,3050,ground,dragon
719,diancie,True,600,250,350,7,88,fairy,rock
720,hoopa,True,600,330,270,5,90,ghost,psychic
721,volcanion,True,600,310,290,17,1950,water,fire
722,rowlet,False,320,147,173,3,15,flying,grass
723,dartrix,False,420,197,223,7,160,flying,grass
724,decidueye,False,530,277,253,16,366,ghost,grass
725,litten,False,320,195,125,4,43,fire,N/A
726,torracat,False,420,255,165,7,250,fire,N/A
727,incineroar,False,530,255,275,18,830,dark,fire
728,popplio,False,320,160,160,4,75,water,N/A
729,brionne,False,420,210,210,6,175,water,N/A
730,primarina,False,530,260,270,18,440,fairy,water
731,pikipek,False,265,170,95,3,12,flying,normal
732,trumbeak,False,355,200,155,6,148,flying,normal
733,toucannon,False,485,255,230,11,260,flying,normal
734,yungoos,False,253,145,108,4,60,normal,N/A
735,gumshoos,False,418,210,208,7,142,normal,N/A
736,grubbin,False,300,163,137,4,44,bug,N/A
737,charjabug,False,400,173,227,5,105,electric,bug
738,vikavolt,False,500,258,242,15,450,electric,bug
739,crabrawler,False,338,187,151,6,70,fighting,N/A
740,crabominable,False,478,237,241,17,1800,ice,fighting
741,oricorio-baile,False,476,261,215,6,34,flying,fire
742,cutiefly,False,304,184,120,1,2,fairy,bug
743,ribombee,False,464,274,190,2,5,fairy,bug
744,rockruff,False,280,155,125,5,92,rock,N/A
745,lycanroc-midday,False,487,282,205,8,250,rock,N/A
746,wishiwashi-solo,False,175,85,90,2,3,water,N/A
747,mareanie,False,305,141,164,4,80,water,poison
748,toxapex,False,495,151,344,7,145,water,poison
749,mudbray,False,385,190,195,10,1100,ground,N/A
750,mudsdale,False,500,215,285,25,9200,ground,N/A
751,dewpider,False,269,107,162,3,40,bug,water
752,araquanid,False,454,162,292,18,820,bug,water
753,fomantis,False,250,140,110,3,15,grass,N/A
754,lurantis,False,480,230,250,9,185,grass,N/A
755,morelull,False,285,115,170,2,15,fairy,grass
756,shiinotic,False,405,165,240,10,115,fairy,grass
757,salandit,False,320,192,128,6,48,fire,poison
758,salazzle,False,480,292,188,12,222,fire,poison
759,stufful,False,340,170,170,5,68,fighting,normal
760,bewear,False,500,240,260,21,1350,fighting,normal
761,bounsweet,False,210,92,118,3,32,grass,N/A
762,steenee,False,290,142,148,7,82,grass,N/A
763,tsareena,False,510,242,268,12,214,grass,N/A
764,comfey,False,485,234,251,1,3,fairy,N/A
765,oranguru,False,490,210,280,15,760,psychic,normal
766,passimian,False,490,240,250,20,828,fighting,N/A
767,wimpod,False,230,135,95,5,120,water,bug
768,golisopod,False,530,225,305,20,1080,water,bug
769,sandygast,False,320,140,180,5,700,ground,ghost
770,palossand,False,480,210,270,13,2500,ground,ghost
771,pyukumuku,False,410,95,315,3,12,water,N/A
772,type-null,True,534,249,285,19,1205,normal,N/A
773,silvally,True,570,285,285,23,1005,normal,N/A
774,minior-red-meteor,False,440,180,260,3,400,flying,rock
775,komala,False,480,255,225,4,199,normal,N/A
776,turtonator,False,485,205,280,20,2120,dragon,fire
777,togedemaru,False,435,234,201,3,33,steel,electric
778,mimikyu-disguised,False,476,236,240,2,7,fairy,ghost
779,bruxish,False,475,267,208,9,190,psychic,water
780,drampa,False,485,231,254,30,1850,dragon,normal
781,dhelmise,False,517,257,260,39,2100,grass,ghost
782,jangmo-o,False,300,145,155,6,297,dragon,N/A
783,hakamo-o,False,420,205,215,12,470,fighting,dragon
784,kommo-o,False,600,295,305,16,782,fighting,dragon
785,tapu-koko,True,570,340,230,18,205,fairy,electric
786,tapu-lele,True,570,310,260,12,186,fairy,psychic
787,tapu-bulu,True,570,290,280,19,455,fairy,grass
788,tapu-fini,True,570,255,315,13,212,fairy,water
789,cosmog,True,200,95,105,2,1,psychic,N/A
790,cosmoem,True,400,95,305,1,9999,psychic,N/A
791,solgaleo,True,680,347,333,34,2300,steel,psychic
792,lunala,True,680,347,333,40,1200,ghost,psychic
793,nihilego,False,570,283,287,12,555,poison,rock
794,buzzwole,False,570,271,299,24,3336,fighting,bug
795,pheromosa,False,570,425,145,18,250,fighting,bug
796,xurkitree,False,570,345,225,38,1000,electric,N/A
797,celesteela,False,570,269,301,92,9999,flying,steel
798,kartana,False,570,349,221,3,1,steel,grass
799,guzzlord,False,570,241,329,55,8880,dragon,dark
800,necrozma,True,600,313,287,24,2300,psychic,N/A
801,magearna,True,600,290,310,10,805,fairy,steel
802,marshadow,True,600,340,260,7,222,ghost,fighting
803,poipole,False,420,219,201,6,18,poison,N/A
804,naganadel,False,540,321,219,36,1500,dragon,poison
805,stakataka,False,570,197,373,55,8200,steel,rock
806,blacephalon,False,570,385,185,18,130,ghost,fire
807,zeraora,True,600,357,243,15,445,electric,N/A
